I I I I I I I I I I I I I I I
W W W W W W W W W W W W W W W 
W E E E E E E E E E W W W W W 
W W W W W W E W W E W W W W W 
W W W W W W E W W E W W W W W
W W W G W W E W W E W W W W W
W W W E W W E W W E W W W W W
W W W E W W W W W E E E E W W
W E E E E E E E E E W W W W W
W E W W W W W W W W W W W W W
W E E E E E E E E E E E E E W
W E W W W W W W W W W W W E W 
W E E E E E E E E E E E E E W
W E W W W W W W W W W W W E W 
W E E E E E E E E E E E E E W
W W W W W W W W W W W W W W W
